############################################################# ###########################################################
#       #   #               #                 #               # #             #             #                 #         #
# # ### # # # ######### ### # ######### ##### # ### ######### # # ##### # ##### ##### # ##### ######### # ### # #########
# #   # # #   #         # # #   #       # #   # # # #       #   # #   # # #     # #   # #     #   #   # #   # #         #
# ### ### ##### ######### # ### # ####### # ### # # # ##### ### # # # # ### ##### # ### # ##### # # # ##### # ##### ### #
#   # #   #     # #       # #   #   # #     # # # # #     # #   #   # #   # #     #   # # #   # # # #       #     # #   #
##### # ### ##### # ### ### ####### # # ##### # # # # ### ### ####### ### # # ####### ### # ### # # ############# ### # #
#   # # #   #   #   # #   #         # # #     # # # #   #     #       # #   # #       #   # #   # #       #     #     # #
# # # # # ### # # ### ### ########### # # ### # # # ### ####### ####### ##### # # ##### ### # ### ####### # ### ####### #
# #   # #   # #   #     # #         # # #   # # # # # #   #     # #           # # #     #     #       # #   #   # #   # #
# ##### ### # ####### # # # ##### # # # # # # # # # # ### # ##### # ######### # ### ####### ### ##### # ##### ### # # # #
#         # # #     # # # #   # # #   # # # # #   # #     # # #         #     #     #     # #   #   #     # # #   # #   #
# ######### # ### # ### # ### # # ##### # # ##### # # ##### # # ######### ########### ### ### ### # ##### # # # ### #####
# #         #   # #   # #   # # #   #   # #     # # # # #   # # #     #   #           # #   # #   # # #   # # #   # #   #
# # ### ####### # ### # ### # # ### # ##### # ### # # # # ### # # ### # ### ##### ##### ### # ### # # # ### # ### # ### #
# # #   #   #     #   #   # #     # # #   # # #   # #   # #     # # # #     #   # #       # #   # #   #     #   #   #   #
# # # ### # ####### ##### # ##### # # # # ### # ### # ### # ##### # # # ####### # # ### # # ### # ######### ### # ### # #
# # #   # #   #     #     #   #   # #   #   #   #   # #   # #     #   # #   #   # #   # # #   # #     #   #   # #     # #
# # ##### ### ### ##### ##### # ### ####### # ### ### # ##### ##### ### # # # # # ##### ##### # ##### # # ### # ####### #
# #       # #   #   #   #   #   #     #   # # # # #   #   #   #     # # # # # # #     #       #     #   #     #   #     #
# ######### ### ### # ### # ##### ### # ### # # # ####### # ### ##### # # # # # ##### # ##### ##### # ########### # #####
# #           # #     #   #     #   #   #   # # #       #   # # #       # #   # #     # #   #       #     #     # # #   #
# # ######### # ##### # ####### ### # ### ### # ####### ##### # ##### ### # ##### # ##### # ############# # # ### # # # #
# #   #       #   #   # #   #   #   # #   # # #   # #   #     #     # #   # #     # #     #     #       # # #   # #   # #
# ### # ##### ### # ### # # ### # # ### ### # # # # # ### # # ##### # # ##### ### ### ######### # ##### # ##### # ##### #
#   # #     #   # #   #   #   #   # #   #       #   # #   # #   #   #   #     # # #   #       #   #   # #       #     # #
### ####### ### # # ######### ####### ############# # # ### ##### ####### ##### # # ##### ########### # # ########### ###
# #       # #   # # #       #   #   # #           # #     # #     #       #   #   # #     #           # # #         #   #
# ####### # ##### ### ##### ### # # # # ######### ######### # ##### # ##### # # ### # ### # ### ####### ### ####### ### #
# #     # #   #   #   #   #   #   #   #   # #           #   # #     # #     #   #   # #   #   #     #   #   #     #     #
# # ### # ### # # # ### # ### ##### ### # # # ######### # # # ####### ### ####### ### ####### ##### # ### ### ######### #
#   #   #   # # # #   # #     #   # #   # #     #   # #   # #       #   #       # #           #   # # # #   # #       # #
# ### # ### # # ##### # ####### # # ##### ####### # # ##### ####### # # ####### # ####### ##### # # # # # # # # # ### # #
#   # # # #   #   #   #         # #     #         # #       #     # # # #   #   #       #     # #   # # # # # # # #   # #
##### # # ### ### # ############# ##### # ######### # ##### # # # # ### # ### ######### ####### ### # # # # # # # ### # #
#     #     # # #   #   #   #   # #   # #       #   # #   # # # # # #   # #   #         #   #   #   # #   # #   #   # # #
# ####### ### # ####### # # # # # # # # ######### ### # # ### # ### # ### # ### ######### # # ##### # # ### # ##### ### #
# #     # #   #       # # #   # # # #   #         #   # #     #       #       # #         #   #   # # #   # # #   #     #
# # ### ### ### # ### # # ##### # # ##### ######### ### ####################### ##### # ####### # # # ##### # # # #######
# #   #     #   # # #   # #       #       #   #   #   #   #   #         #     #     # #       # # # #   #   # # #       #
# # ####### ##### # ### # # ############### ### # ### ### # # # ####### # ### ##### # ####### # # ##### # ### # ####### #
# # #     #       # #   # # #     #   #         #   # #   # # # #         # # #     # #   #   # #     #   # # #   #   # #
# # # ### ######### # ### # # ### # ### ######### ### # ### # # ########### # # ##### # ### ### ##### ##### # ### ### # #
#   #   # #     #       # # # #   #             #     # #   # #       #     #   #   # #   #     #   #     # # #       # #
####### # # ### ####### # ### # ######### ############# ##### ####### ### ####### ### # # ####### # # ### # # # ####### #
#       #   # #       # #     #     #   # #             #   #       # #   #       #   # #         # #   #   # # #     # #
# ########### ####### # ########### # # ### ############# # # # ##### # # # ### ### ####### # ##### ### ##### ### ### # #
# #             #     #     #     #   #     #   #     #   #   # #     # # #   #     #     # #   #   #   #   #     # #   #
# # ######### ### ######### # ### ########### # ### # # ######### ##### ##### ####### ### # ### ### # ### # ####### ### #
# #         # #   #   #     #   #         #   # #   #   #     #   #       #   #     # # # #   #   # #     #     #   #   #
# # ######### # ### # # ########### ##### ### # # ##### # ### # ####### # # ##### # # # # ####### ############# # # # ###
# # #       # # #   # #   #         #   #     #   #   # #   #   #     # #         # # #   #     #             # # # # # #
# ### ##### # # # ####### # # ####### # ########### ### ### ##### ### # ########### # # ### ### # ### ######### # # # # #
# #   #   # #   # #     #   # #     # # #           #   # #       # # #   #   # #     #     # # # # # #       # # # #   #
# # ### ### # ### # ### # ##### ### # # # # ### ##### ### ######### # ##### # # # ########### # # # # # ##### # # # ### #
#       #   # #   # # #   #   #   #   # # #   # #     #           # #       # #   #         #   #   # # #   #   # #     #
######### ### # ### # ##### # # # ##### ### # # # ##### ######### # ######### # ### ####### # ##### # # # # ### # #######
#         #   #     #   #   # # # #       # # # # #   # #       # #   #     # #   # #   #   # # #   # #   #   # # #     #
# ######### ##### ##### # ### ### ####### ### ### # # # # ##### # # # # ##### ##### # # # ### # # ### ####### ### # ### #
# #       #     #     # #   #   #     # #   #       #   # # #   # # #   #   #     # # # # # # #   #   #     #     # # # #
# # ##### ##### ##### # ### ### # ### # ### ####### ##### # # ### # ##### # # ### # # # # # # ##### # # ### ####### # # #
# #   # #   #   #         # #   # #   # #   #     # #     #   #     #   # # #   #   # # # #   #     # # # #         #   #
##### # # ### ### ######### # ### # ### # ### ### ### ##### ######### # # # ####### # # # # ### ##### # # # ######### ###
#     #   #   # # #   #     #   # #   # #     #   #   #   #         # # # #       # # # # # #     #   # # #   # #     # #
# # ####### ### # ### # ####### # ### # ####### ### ### ########### # # # ####### # # ### # ##### ##### # ### # # ##### #
# # #   #   #   #     #   #     # # # #       # #   #   #         #   # #   #     # # #   # #   #           # # #   #   #
# ### # # ### # # ####### # ##### # # ####### # # ### # # ### ######### ### # ##### # # ### # # # ########### # ### # ###
#     # # #   # # #       #   #     #   #     #   # # #   # # #       #     # #   # # # #   # # #   #       # #   # #   #
# ##### # # ##### # ######### # ####### # ### ##### # ##### # # ##### ####### # ### # # # ### # ##### ##### # ### # ### #
#   # #   # #     #   #       # #   #   # #   #     #   #   # # #   #     #   #       # #     # #     #   # # #   #   # #
### # ##### # ####### # ######### # # ### # ### # # ### # ### # # ####### # ##### ##### ####### # ####### # # # # ### # #
# # #   #   #   #     #           #   #   #   # # #   #   #   # #   #     #     # #   #     # # # # #     #   # #   #   #
# # # ### # ### # ### ################### # ### # ####### # ### # # # ### ##### # # # ##### # # # # # # ####### ### ### #
#   # #   #     #   # #     #   #         # #   #         # #   # # #   #     # # # # #   # #     #   #         #   #   #
# ### # ########### ### ### ### # ##### # ### ####### ##### # ### # ### ##### # ### # # # # ####### ####### ##### ### ###
# #       #       #   # # #   # # #   # # #   #     #     # #   # # #   #   # #     #   # # #   #     #     #     #   # #
# ####### ####### ### # # ### # # # # # ### ### ### ### ### ### # # # ##### # ########### # # # # ##### ####### ### ### #
#       #       #   #   # #   #   # #   #   #   # # #   #     # # # # #   #   #   #     # #   # # #   #   #   #   # #   #
####### ####### # # ##### # ##### # ##### ### ### # ##### # ### ### # # # # ### # # ### # # ### ### # # # # # ##### # # #
#       #   #   # #     # # #   # #       # # #           # #   #   #   # #   # # #   #   #   #     # # # # #       # # #
# ######### # ####### # # # # # # ######### # ############### ### # ##### ### ### ### ##### ######### # # # ######### ###
#   #     #         # #   # # # #     #   # #                 #   # #   #   #     #   #     #         # # #   #     #   #
### # ### ######### # ##### # # ##### # # # ##################### # ### ### ####### ######### ########### ### ##### # # #
#   #   #     #       #   #   # #   #   #     #     #       #     # #     #     #   #       # #             #     #   # #
# ### # ##### ### ##### # ##### # # ######### ##### # ### ### # ### # ### ##### # ##### ### # # ##### ########### ##### #
# #   #   #     # #   # #       # #         # #     #   #     # # #   # #   #   #     # #   # # #   # #   #           # #
# ##### # ##### ### # # ############# ####### # ####### ####### # ##### ### # ####### # # ### # # # ### # # ######### # #
#     # #   #       # # #   #       # #   #   #       #   #     #     #   # #       #   # #   #   #     #   #     #     #
##### ### # ######### # # # ### ### # # # # ##### ### ### # ##### # ### # # ####### ##### ### ####### ####### ### #######
#   #   # # #       #   # #   #   #   # # #     #   #     #     # #   # #   #   # #     #   #       # #       # #   #   #
# ##### # # # ##### ##### ### # # ##### # ##### ### ####### ### # ### # ##### # # ##### ### # ##### ### ####### ### # # #
#     # # #   #   #     # # # # #       #     # #   #     # #   #   #   # #   #     #     # #     # #             #   # #
### # # # ##### # ##### # # # # ########### ### ##### ### # # ####### ### # # ####### ### # ##### # # ################# #
#   # # #   #   #     #     # # #     #   #   #     # #   # #   #   #   #   # #       #   #     # #   #           #     #
# ### # ### # ############### # # ### # ##### ##### # # ####### # # ### ##### # # ############# # ##### ######### # ### #
# #   #   #   #     #         #   #   # #         # # #   #     # # #         # # #   #     #   # #   #     #       #   #
# ####### ### # ### # ### ########### # # ######### # ### # ##### # ######### # ### # # # # # ### # # # ### ######### ###
#       # #   #   # #   # #         #   #         # # #   #       #       #   # #   # # # # # #   # # # # #     #   #   #
# ##### # ####### # ### ### ####### ### ######### # # # ### ############# ### # # ### # # ### ##### # # # ##### # # ### #
# #     #   #     #   #       #   # #       # #   #   # #   #           #   # #   #   # #   # #     # #       # # #   # #
### ### ### # ####### ####### # ### ####### # # # ##### # ### ### ######### ####### ### ### # # ##### ######### ### ### #
#   #     #   #       #   #     #   #   #   # # #   #   #     #   #       #       #   #   # # # #   #           #   #   #
# ############# ####### # ####### ### # # ### # ##### ####### ##### ##### # ### ##### ### # # # # ############### # # ###
#             #   #     #       #     # #     #       #     # #   # #     # # #     #   # #   # #       #       # # # # #
# ########### ### ### ######### ####### ##### ########### # # # # # # ##### # ### # # # # ##### # ### ### ### # # # # # #
#       #       #   # #         #       #   #             # # # # # # #   # #   # # # # # #     # # #       # # # # # # #
##### ### # ####### # # ######### ####### ################# ### # # # # # # ### # ### ### # ##### # ######### # # ### # #
#   # #   # #     #   # #         #       #               # #   #   # # #     # #   #     #   #       #   #   # # #   # #
# # ### ##### # ####### ##### ##### ##### # ##### ####### # # ####### ####### # ### ######### ####### ### # ### # # ### #
# #     #     #       #       #     #   # # #   #   #   # #   #     #       #   # #         #   #         #   #   # #   #
# ### ### ########### ########### ### ### # # ##### # # ####### ### ####### ### # # ####### # # ########### # ##### # # #
#   # #   #   #   # #             #     # # # #   #   #         #         # #     # #       # #   #   #   # #       # # #
### # # ### # # # # ########### ### ### # # # # # ######### ############# # ##### # ####### ##### # # # # # ######### # #
#   # # #   #   #       #       #     #   # # # #           #         #   #   #   #       #     #   # # # # #         # #
# ##### # ############# # ##### ##### ##### # # ########### # ####### ### ### ##### ##### ##### # ### # # # # ######### #
#     #   #       #   # #   #   #   #   #   # # #       #   #       #   # # #     # #   # #   # #   #   # # # #         #
# ### ##### # ##### # # ### ##### # ### # ### # # ##### # ######### ### # # ##### ### # # # # # ####### # # ### ####### #
# # #     # #     # # # # # #     #   # # #   # #   #   #       #   # # #   #   # #   #   # # #   #   # # #     #     # #
# # ##### # ##### # # # # # # ####### ### ### # ### # ########### ### # ##### # # # ####### ##### # # ### ####### ### # #
#       #       #   #     #         #         #     #                 #       #     #               #     #         #   #
############################################################# ###########################################################
