############################### #############################
#           #       #                         #           # #
# ### ##### # ### # # ##################### ### ### ##### # #
# #   #     #   # # #     #   #     #   #   #     # #   #   #
# # ### ######### ####### # # # ### # # # ### ##### # # ### #
# # # # #       #       # # #   #   # # # #   # #   # # #   #
# # # # # ##### ### ##### # # ##### # # # # ### # ### # # ###
# # #     #   # #   #   # # # #   #   #   #   # # # # #   # #
### ######### # # ### # # # ### # ########### # # # # ##### #
#   #       #     #   #   #     #           #   # # #   #   #
# ### ##### # ##### ####################### ### # # ### ### #
#   # #   # # #   #   # #                 #   # # #         #
# # # ### # ### # ### # # # ####### # ### # ### # # #########
# #       #     # #   #   #       # #   # #     # # #       #
# ############### # ### ##### ### # ### # ####### # # ##### #
# #             # #     #   # # # # #   # #     # # # # #   #
### ########### # # ##### # # # # # # ### # ### # ### # # ###
#   #       # # # #       # #   #   # #   # #   # #   # #   #
# ### ### # # # # ######### # ####### ### # ### # # ### ### #
#   # # # #   #     #   # # # #     #   # #   # # #       # #
### # # # # ####### # # # # # # ### ### # ### # # ##### ### #
#   #   # # #     #   #   # # #   #     # #   # #       #   #
# # ##### ### # ######### # # ### ####### # ############# # #
# # #   #     #         # # #   # #     # # #     #   #   # #
# ### # ############# ### # ##### # ### # # # # # # ### #####
# #   #       #     # #   #     # #   #   # # # #   #   #   #
# # ######### # ### # # ####### # ### ##### # # ##### ### # #
# # #         # # # #         #   # # #     # # #   #     # #
# # # ####### # # # ############### # # # ### # # # ####### #
#   # #   # # #   # #               # # #     #   #     #   #
# ### # # # # ### # # ######### ##### ########### # ### # ###
# # #   # # # # # # #   #     #     # #         # # #   #   #
# # ##### # # # # # ### # ######### # # ####### ### # #######
#     #   #     # # #   #   #   #   #   #     #     # #     #
##### # ### ##### # # ##### # # # ####### # # ####### # ### #
# #   # #   #     #         # # #   #   # # #       # # #   #
# # ### # ### ############### # # # # # # # ######### ### # #
# # # # #   # #       #       # # #   #   #       #   #   # #
# # # # ### # ### ##### ####### # ############### # ### ### #
#   # # #   #   # #   #     #   # #       #     # # #     # #
# ### # # ##### # # # ##### ### # ####### # ### # # # ### # #
#   # # #     # #   #     #   # #     #   #   #   # # #   # #
### # # ##### # ### ### # ### # ##### # ##### ### # ### #####
# # # #     # #   #   # # #   #     # # #     # # #   #     #
# # # ##### ##### ##### # # ####### # # # ##### # ### ##### #
#   # #   #     # #     # #   #   # #   #   #   # # #       #
# ### # # ##### # # ### ##### # # # ####### # # # # ####### #
# #   # #     #     #   #     # # #         # # #   # #   # #
# # # # ### # ########### ### # # ########### ##### # # # # #
# # #   # # #   #       #   # # # #   #       #       # # # #
# ##### # # ### # ##### ### ### # # # ##### # # ####### # # #
#     # # # # # # #   #   # #     # # #   # #   #       #   #
##### # # # # # # # # ### # # ### # # # # # ##### ###########
#   # #   # # # # # # #   # # # #   #   # # #     #   #     #
### # # ### # # # ### # ### # # ######### ### ##### # # ### #
#   # # #   #   #   #   #   #       #   #     #     #   # # #
# # # ### ### ##### # ### ######### # # ######### ####### # #
# # #     # #   # # #     #       # # #         #         # #
# ######### ### # # ####### ### ### ##### ##### ########### #
#                 #           #           #                 #
############################### #############################